##########################################################
#........................................................#
#.###.#########.###############.########.###.#####.#####.#
#.###.#########.###############.########.###.#####.#####.#
#.....#########....J.............J.......###.............#
#####.###.......#######.#######.########.###.#######.#####
#####.###.#####J#######.#######.########.###.##   ##.#####
#####.###L#####.##   ##L##   ##.##    ##.###.##   ##.#####
#####.###..H###.##   ##.##   ##.########.###.#######J#####
#####.#########.##   ##L##   ##.########.###.###V....#####
#####.#########.#######.#######..........###.#######.#####
#####.#########.#######.#######.########.###.#######.#####
#.....................L.........########..........R......#
#L####.##########.##.##########....##....#########.#####.#
#.####.##########.##.##########.##.##.##.#########.#####.#
#.................##............##..@.##...............R.#
##########################################################
